#########
#    ####
# @@@####
#  #GG###
##  GG@ #
## P    #
#########