##########
#######  #
# @ @ @  #
# GGGGGGP#
#  @ @ @ #
#  #######
##########