###########
#P @    G##
#  # @    #
#         #
#  #G     #
###########