######
#P  ##
#G@G #
# @# #
#    #
######