#########
#P  #####
# @@#####
# @ ###G#
### ###G#
###    G#
##   #  #
##   ####
#########