###########
#P @    G##
#  # @    #
#         #
#G #      #
#####     #
#   # @   #
#   #     #
#G        #
###########